# Configuration
yes="j"
no="n"
yesmatch="j"
nomatch="n"
agent="agent"
local="lokal"
server="server"
help="hilfe"


# Global
moreinfo="Weitere Informationen unter: "
starting="Starte openarmor HIDS"
systemis="Erkanntes System "
modifiedinit="Init script wurde ver�ndert uopenarmorEC HIDS beim boot zu starten."
noboot="Unbekanntes system. Es wurde kein Init-Script kopiert."

# Part 1
installscript="Installations Script"
system="System"
user="User"
host="Host"
hitanyorabort="Drücken Sie eine Taste zum fortfahren oder Ctrl-C zum abbrechen"
whattoinstall="Welche Art der Installation möchten Sie starten (server,agent,lokal oder hilfe)?"
serverchose="Server installation ausgewählt"
clientchose="Agent(client) installation ausgewählt"
localchose="Lokale installation ausgewählt"

# Part 2
settingupenv="Die Installation wird vorbereitet"
wheretoinstall="Bitte w�hlen Sie wopenarmorEC HIDS installiert werden soll"
installat="Die Installation wird kopiert nach "
deletedir="Das Installationsverzeichniss existiert bereits. Soll es gel�scht werden? "

# Part 3
configuring="Konfiguration "
mailnotify="M�chten Sie Benachrichtigungen per E-Mail? "
nomail="E-Mail Benachrichtigung wird �bersprungen "
whatsemail="Wie lautet die E-Mail Adresse? "
yoursmtp="Es wurde dieser SMTP Server gefunden"
usesmtp="Soll er benutzt werden?"
usingsmtp="Benutze SMTP Server: "
whatsmtp="Wie lautet die Adresse des SMTP Servers? (IP/Host) "

# Part 3.1/agent
serverip="Wie lautet die IP Adresse des openarmor HIDS Servers?"
serveraddr="Wie lautet die IP Adresse/Host des openarmor HIDS Servers?"
addingip="Server IP hinzugef�gt"
addingname="Server Host hinzugef�gt"


# Part 3.2
runsyscheck="M�chten Sie den syscheck (integrity check daemon) benutzen?"
nosyscheck="Syscheck (integrity check daemon) wird nicht benutzt"
yessyscheck="Syscheck (integrity check daemon) wird gestartet"

# Part 3.3
runrootcheck="M�chten Sie die rootkit detection engine benutzen?"
norootcheck="Rootcheck (rootkit detection) wird nicht benutzt"
yesrootcheck="Rootcheck (rootkit detection) wird gestartet"

# Part 3.4/server/local
enable_ar="M�chten Sie active response benutzen?"
noactive="Active response wird nicht benutzt"
nohosts="host-deny ausgeschaltet"
yeshosts="host-deny (local) f�r level >= 6 eingeschaltet "
firewallar="M�chten Sie firewall-drop benutzen?"
nofirewall="firewall-drop ausgeschaltet"
yesfirewall="firewall-drop (local) f�r level >= 6 eingeschaltet"
defaultwhitelist="Standard Ausnahmeliste (White-list) für active response:"
addwhite="Möchten Sie weitere IPs zur White-list hinzufügen?"
ipswhite="IPs (Durch Leerzeichen getrennt): "


# Part 3.5/server/local
syslog="M�chten Sie Nachrichten von einem remote syslog (514 udp) empfangen?"
nosyslog="Remote syslog empfang ausgeschaltet"
yessyslog="Remote syslog empfang eingeschaltet"

# Part 3.4/3.5
readlogs="Die folgenden Log-Files werden analysiert:"

# Part 5
installing="Installiere das System"
runningmake="make wird ausgef�hrt"

# Final
configurationdone="Konfguration erfolgreich durchgef�hrt "
tostart="Um openarmor HIDS zu starten"
tostop="Um openarmor HIDS zu stoppen"
configat="Die Konfiguration kann angesehen oder ver�ndert werden unter: "
addserveragent="Agenten m�ssen hinzugef�gt werden bevor sie zugreifen k�nnen. "
runma="Run the 'Benutzen Sie manage_agents um Agenten hinzuzuf�gen oder zu entfernen"
presskey="Dr�cken Sie eine Taste"

# Update
wanttoupdate="openarmor ist bereits installiert. M�chten Sie es updaten?"
unabletoupdate="Update nicht m�glich. Es mu� eine Neuinstallation durchgef�hrt werden."
updatecompleted="Update durchgef�hrt."
updatefailed="Update fehlgeschlagen."
updaterules="M�chten Sie die Regeln updaten?"
updatingrules="Regeln werden upgedated."
notupdatingrules="Regeln werden nicht ver�ndert."

# Pf support
pfenable="Moechten Sie die PF Firewall f�r active response benutzen?"
nopf="active response fuer PF Firewall ausgeschaltet."
pftablename="Name der PF Tabelle die benutzt werden soll?"
pfmessage="Fuegen Sie die folgende Zeile am Anfang Ihrer Regeln ein "


